~~~~~~~~~~~~~~~~~~~~~~~~~~~~~
~............D..............~
~...........................~
~....H......................~
~...........................~
~D..........................~
~...........................~
~...........................~
~...........................~
~............D..............~
~~~~~~~~~~~~~~~~~~~~~~~~~~~~~