~~~~~~~~~~~~~~~~~~~~~~~~~~~~~
~...........................~
~...........................~
~...........................~
~.....W...............Q.....~
~...........................~
~...........................~
~...........................~
~...........................~
~.............D.............~
~~~~~~~~~~~~~~~~~~~~~~~~~~~~~