~~~~~~~~~~~~~~~~~~~~~~~~~~~~~
~.............H.............~
~...........................~
~...TTTTTT.........TTTTTT...~
~...........................~
~...TTTTTT.........TTTTTT...~
~...........................~
~...TTTTTT.........TTTTTT...~
~...........................~
~.............D.............~
~~~~~~~~~~~~~~~~~~~~~~~~~~~~~