~~~~~~~~~~~~~~~~~~~~~~~~~~~~~
~.............D.............~
~...........................~
~................H..........~
~...........................~
~D.........................D~
~...........................~
~...........................~
~...........................~
~...........................~
~~~~~~~~~~~~~~~~~~~~~~~~~~~~~