~~~~~~~~~~~~~~~~~~~~~~~~~~~~~
~...........................~
~............E..............~
~...........................~
~.....Q...............Q.....~
~...........................~
~...........................~
~...........................~
~...........................~
~.............D.............~
~~~~~~~~~~~~~~~~~~~~~~~~~~~~~