~~~~~~~~~~~~~~~~~~~~~~~~~~~~~
~.............L.............~
~...........................~
~...TTTTTT.........TTTTTT...~
~...........................~
~...TTTTTT.........TTTTTT...~
~...........................~
~...TTTTTT.........TTTTTT...~
~...........................~
~.............D.............~
~~~~~~~~~~~~~~~~~~~~~~~~~~~~~