~~~~~~~~~~~~~~~~~~~~~~~~~~~~~
~...........................~
~............E..............~
~.....QQQQQQQQQQQQQQQQQ.....~
~.....Q..Q...Q...Q...QQ.....~
~.....Q.Q.Q.Q.Q.Q.Q.Q.Q.....~
~.....QQ...Q...Q...Q..Q.....~
~.....QQQQQQQQQQQQQQQQQ.....~
~...........................~
~.............D.............~
~~~~~~~~~~~~~~~~~~~~~~~~~~~~~