~~~~~~~~~~~~~~~~~~~~~~~~~~~~~
~...........................~
~.............W.............~
~...........................~
~.....W...............W.....~
~...........................~
~...........................~
~...........................~
~...........................~
~.............D.............~
~~~~~~~~~~~~~~~~~~~~~~~~~~~~~