~~~~~~~~~~~~~~~~~~~~~~~~~~~~~
~.............D.............~
~...........................~
~...........................~
~...........................~
~D.........................D~
~...........................~
~..................L........~
~...........................~
~...........................~
~~~~~~~~~~~~~~~~~~~~~~~~~~~~~